--------------------------------------------------
|                                                |
|                      #                         |
|                      #                         |
|                      #                         |
|                      #                         |
|                                      #         |
|                 #####                #         |
|                 #                              |
|                 #                     #        |
|                 #                    #         |
|                      #               #         |
|                      #               #         |
|                      #               #         |
|                                      #         |
|                      ########                  |
|                                                |
|   ####         ##      #                       |
|                     #                          |
--------------------------------------------------